1111111111111111111111
1A11        1 1      1
1    111111 1 111111 1
111111        1      1
1    1 111111 11 11111
1 1111 1         1   1
1        111 111   1 1
1111111111    111111 1
1          11       F1
1111111111111111111111







